....................
....................
...........MMM....MM
....................
....................
....................
....................
....................
....................
....................
....................
....................
....................
...........MMMMM....
....................
....................
....................
......MMMM..........
....................
..................h.
MMM.............acml
dkfcaabbbbabbabacmfo
glhkccccccccccccmhmt
ts...fmkmEefhlmmfmtA
CDs.CkldlsgdjtAstACA
ACDABABqACsklAABACBA