......K.............
......K.............
......K...KKKKK...KK
......K...K...K...K.
......K...K...K...K.
..........K...K...K.
..........K...K...K.
..........K...K...K.
..........KKKKK...K.
......L...........K.
......L...........K.
......K...........K.
......K...........K.
......K...KKKKKKKKK.
..........K.........
..........K.........
..........K.........
......LKKKK.........
...................a
..................ac
................aaaa
aaaaaaaaaaaaaaaaa...
....................
....................
....................
....................