...###
..##.#.####
.##..###..#
##........#
#...@..#..#
###..###..#
..#..###..#
.##.##.#.##
.#.......##
.#......##
.#R....##
.#######