.....................
.....................
#..............#....#
#.....S.....S..#....#
#..............#....#
#..............#....#
#.........T....#....#
#..............#....#
#...................#
#...................#
.###............###.
.....##........##....
#...................#
#......@.....R#..H..#
#####################