.....................
.....................
#....#.........#....#
#....#.........#....#
#....#.........#....#
#....#.........#....#
#....#....T....#....#
#....#.........#....#
#...................#
#...................#
.###............###.
.....##........##....
#......R....R.......#
#......@............#
#####################